PPPPPPPPPPPPPPPP
PSSSSSSSSSSSSSSP
PBSSSSBSSBSSSSBP
PPPSTSPPPPSOSPPP
PSSSSSSSSSSSSSSP
PSSSBSSSSSSBSSSP
PSSPPPSSSSPPPSSP
PSSSSSSSSSSSSSSP
PBSSSSSHSSSSSSBP
PSSSSPPPPPPSSSSP
PSSSSSSSSSSSSSSP
PSSBSSSSSSSSBSSP
PSPPPSSOSSSPPPSP
PSSSSSSSSSSSSSSP
PBSSSSBSSBSSSSBP
PPPPPPPPPPPPPPPP