PPPPPPPPPPPPPPPP
PBSSSSSSSSSSSSBP
PSSSSSSSSSSSSSSP
PBSSSSSSSSSSSSBP
PSSOSSSSSSSSOSSP
PSSSSSBSSBSSSSSP
PSSSSSSSSSSSSSSP
PSBSSSSSSSSSSBSP
PPPPSSSSSSSSPPPP
PBSSSSSSSSSSSSBP
PSSSSSSSSSSSSSSP
PSSSSPPPPPPSSSSP
PSSSSSBSSBSSSSSP
PBSSSSSSSSSSSSBP
PPPSSSSHSSSSSPPP
PPPPPPPPPPPPPPPP