PPPPPPPPPPPPPPPP
PSSSSSSBBSSSSSSP
PBSSSSPPPPSSSSBP
PSSOPPSBBSPPOSSP
PTSSSSSSSSSSSSTP
PSSSSSPSSPSSSSSP
PBSSSSSSSSSSSSBP
PPPPSSSSSSSSPPPP
PSSSSSBSSBSSSSSP
PSOSSSPPPPSSOSSP
PSSSSSSSSSSSSSSP
PSBSSSSSSSSSSBSP
PPPPSSSSSSSSPPPP
PSSSSSSSSSSSSSSP
PBSSSSSSHSSSSSBP
PPPPPPPPPPPPPPPP