PPPPPPPPPPPPPPPP
PSSSSSBOSBSSSSSP
PSSSPPPPPPPPSSSP
PBSSSSSSSSSSSSBP
PPPPPPSSSSPPPPPP
PSSSSSSSSSSSSSBP
PSSSSOSBSSSSSSSP
PPPPPPPPPPPPSSSP
PBSSSSSSSSSSSSSP
PSSSSSSBOSSSSSSP
PSSSPPPPPPPPPPPP
PSSSSSSSSSSSSSBP
PSSHSSSSSSSSSPPP
PPPPPPPSSSSSSSSP
PBSSSSSSSSSSSTBP
PPPPPPPPPPPPPPPP