PPPPPPPPPPPPPPPP
PBSSSSOSSSSSSSBP
PPPSSSSSSSBSSSSP
PSSSSSSSSPPPSSSP
PSSSSBSSSSSSSSSP
PSSSPPPSSSSSSSSP
PSBSSSSSSSTSSSBP
PPPSSSSSSSSSSSSP
PSSSSBSSSSSSSSSP
PSSSPPPSSSSSSSSP
POSSSSSSSSBSSSSP
PBSSSSSSSPPPSSSP
PSSSSSSSSSSSSHSP
PPPSSSSSSSSSSPPP
PBSSSSSSSSSSSSBP
PPPPPPPPPPPPPPPP